#############.#############
###########################
###########################
###########################
###########################
###########################
###########################
###########################
###########################
###########################
###########################
###########################
#####################..####
##......##############..###
##.####....####....####..##
##.##.....######.....###.##
##.####.....###.....####.##
##...........#...........##
#########.........#########
##########...@...##########
###########################