#############&#############
######.........#####..#####
####....#####..#####.######
#.....####...........######
#.#####....########....####
#..##...##....########.####
##....######....#####..##.#
#############..######..#..#
####......#...............#
#....#...##..#..#....####.#
#....##.....##..#..####...#
#...#########..######...###
#...#################..####
##........##............###
##.######....##...#####..##
##.#######..############.##
##.########.#####...####.##
##...........#...........##
############......#########
##########...@.############
###########################