#############&#############
#############.#############
#############.#############
#############.#############
#############.#############
#############....##########
#############.#############
#############.#############
#############.#############
###########........########
#############.#############
#############.#############
#############.#############
#############.#############
#############.....#########
#############.#############
######........#############
#############.#############
#############.#############
############.@.############
###########################