#############&#############
######.........#####....###
####....#####..#####.##.###
#.....#######........##..##
#.#################...##..#
#..##...........####...##.#
##....######....#####..##.#
#############..######..#..#
####...........####......##
#......######..##....######
#..................########
#...#########..######...###
#...#################..####
##........##....#.......###
##.######....##...#####..##
##.#######..############.##
##.########.#####...####.##
##...........#...........##
############......#########
##########...@.############
###########################