#############&#############
#.........................#
#.#.#########.#########.#.#
#.#.##.....##.##.....##.#.#
#...##.###.##.##.###.##...#
##.##..###.......###..##.##
##.##..#############..##.##
##.###...............###.##
##......####...####......##
######..##.......##..######
###.##..###.....###..##.###
#.........................#
#.########.##.##.########.#
#.......##.##.##.##.......#
#..####.#####.#####.####..#
#..#...................#..#
#..#####################..#
#.........................#
#....###...........###....#
############.@.############
###########################