#############&#############
#...#.....................#
#.#.###.########.##.###.#.#
#.#.###.##.#.#.#.##.###.#.#
#.......#........#........#
#.#.#.########.####.####..#
#.#.#.########.##.#.#####.#
#.#......###..........###.#
#.#.###########.#########.#
#.#.###########.#######...#
#.#.....................#.#
#.#.##.#########.##.#######
#.#.##.#########.##.#.#####
#......###.......#........#
#.#.####.##.#.#.##.####.#.#
#.#.####.##.#.####.####.#.#
#####.......#.##.#........#
#########.###.##.##########
#########.###.##..#########
#########....@....#########
###########################