#############&#############
#.........................#
#.#.#########.#########.#.#
#.#.##.....##.##.....##.#.#
#...##.###.##.##.###.##...#
##.##..###.......###..##.##
##.##..#############..##.##
##.###...............###.##
##......####...####......##
######..##.......##..######
###.##..###.....###..##.###
#.........................#
#.########.##.##.########.#
###.....##.##.##.##.......#
#...###.#####.#####.####..#
##.#...................#..#
######..################..#
#######..#####...#........#
########...........####...#
############.@.############
###########################