###########################
###########################
###########################
###########################
###########################
###########################
###########################
######...............######
##......####...####......##
######..####...####..######
######..###.....###..######
#.........................#
#.###########.###########.#
#.......#####.#####.......#
#..####.#####.#####.####..#
#..####.............####..#
#..#####################..#
#.........................#
########...........########
############.@.############
###########################