#############&#############
##........................#
###.#########.#########.#.#
##..##.....##.##..........#
##.#######....##.###.######
##.##..###..########..#####
##.##..####.########..#####
##.###...............######
##......####...####....####
######..##...#######.######
###.##..###.....###..##.###
#.....................#####
#.########.##.##.##.#######
###........########.......#
#..####.###########.####..#
##.#...................#..#
######..################..#
#######..#####...#........#
########...........####...#
############.@.############
###########################