#############&#############
######.........#####....###
####....#####..#####.##.###
#.....#######........##..##
#.#################...##..#
#..##...........####...##.#
##....######....#####..##.#
#############..######..#..#
####...........####......##
#......######..##....######
#..................########
#...#########..######...###
#...##.................####
##......##############..###
##.####....####....####..##
##.##.....######.....###.##
##.####.....###.....####.##
##...........#...........##
#########.........#########
##########...@...##########
###########################