####################
#..................#
#..##############..#
#........##........#
#.######.##.######.#
#.######.##.######.#
#..................#
#####..######..#####
#..................#
#.######.##.######.#
#.######.##.######.#
#........##........#
#..##############..#
#........@.........#
####################